wwwwwwwwwwwwwwwwwwww
ww             w   w
ww             C    
wl         d        
wl  T  c            
wl         wwwwwwwww
wlwwwwwwwwwwwwwwwwww
wl    w           ww
wl    w           ww
wl    B           lw
wl        T  b    lw
wl                lw
wwwwwwwwwwwwwwwwwwlw
w             w   lw
w             w   lw
w             A   lw
w_      T a       lw
w    w            lw
wwwwwwwwwwwwwwwwwwww
--INITIAL STATUS --
