ww             w   w
ww             C    
wl         d        
wl  T  c            
wl         wwwwwwwww
wlwwwwwwwwwwwwwwwwww
wl    w           ww
wl    w           ww
wl    B           lw
wl        T  b    lw
wl 1              lw
wwwwwwwwwwwwwwwwwwlw
w             w   lw
w             w   lw
w             A   lw
w       T a       lw
w    w            lw
wwwwwwwwwwwwwwwwwwww
--INITIAL STATUS --
playerX 300
playerY 2300