w                    w
wwwww w         w wwww
w    Hl         lG   w
w d   l         l  e w
w     l         l    w
wwwwwwl         lwwwww
w    Jl         lI    
w _a  l  b ! c  l     
w     l         l     
wwwwwwwwwwwwwwwwwwwwww
--INITIAL STATUS--
d on