wwwwwwwwwwwwwwwwwwww
ww             w   w
ww             G    
wl         d        
wl  T  c            
wl         wwwwwwwww
wlwwwwwwwwwwwwwwwwww
wl    w           ww
wl    w           ww
wl    F           lw
wl        T  b    lw
wl 1              lw
wwwwwwwwwwwwwwwwwwlw
w             w   lw
w             w   lw
w             E   lw
w_      T a       lw
w    w            lw
wwwwwwwwwwwwwwwwwwww
--INITIAL STATUS --
