wwwwwwwwwwwwwwwwww
w      w   w    ww
w      w   w    ww
w      A   B    lw
w_  ! a  b      lw
w            1  lw
wwwwwwwwwwwwwwwwlw
ww   w  w  w    lw
ww   w  w  w    lw
wl   E  D  C    lw
wl    e  d  c@  lw
wl              lw
wlwwwwwwwwwwwwwwww
wl          w    w
wl          F    w
wl   #f g h        
wl                
wl   wwwwwwwww    
wwwwwwwwwwwwwwwwww
--INITIAL STATUS --
f on
g on
h on