wwwwwwwwwwwwwwwwwwww
ww             w   w
ww             C    
wl         d        
wl  #  c            
wl         wwwwwwwww
wlwwwwwwwwwwwwwwwwww
wl    w           ww
wl    w           ww
wl    B           lw
wl        @  b    lw
wl 1              lw
wwwwwwwwwwwwwwwwwwlw
w             w   lw
w             w   lw
w             A   lw
w_      ! a       lw
w    w            lw
wwwwwwwwwwwwwwwwwwww
--INITIAL STATUS --
