wwwwwwwwwwwwwwwwwwww
ww             w   w
ww             G    
wl         d        
wl  #_ c            
wl         wwwwwwwww
wlwwwwwwwwwwwwwwwwww
wl    w           ww
wl    w           ww
wl    F           lw
wl        @  b    lw
wl 1              lw
wwwwwwwwwwwwwwwwwwlw
w             w   lw
w             w   lw
w             E   lw
w       ! a       lw
w    w            lw
wwwwwwwwwwwwwwwwwwww
--INITIAL STATUS --
terminal ! buffer E a
terminal @ not F b
terminal # and G d c