                
w               
w   w         ww
w   l         lw
w   l   T     lw
w   l         lw
wwwwl wwwwwww lw
w   l       w lw
w   l   ww  w lw
w   l       A l 
w   l     a   l 
w   l w       l 
wwwwwwwwwwwwwwww
--INITIAL STATUS --
a on
