w   w         ww
w   l         lw
w   l         lw
w   l         lw
wwwwl wwwwwww lw
w   l       w lw
w   l   ww  w lw
w   l       D l 
w   l     (   l 
w   l w       l 
wwwwwwwwwwwwwwww